1 -1 -1 -1 -1 -1 -1 -1 -1 -1 -1 -1 -1
2  1 -1 -1 -1 -1 -1 -1 -1 -1 -1 -1 -1
3  2  1 -1 -1 -1 -1 -1 -1 -1 -1 -1 -1
4  3  2  1 -1 -1 -1 -1 -1 -1 -1 -1 -1
5  4  3  2  1 -1 -1 -1 -1 -1 -1 -1 -1
6  5  4  3  2  1 -1 -1 -1 -1 -1 -1 -1
7  6  5  4  3  2  1 -1 -1 -1 -1 -1 -1
8  7  6  5  4  3  2  1 -1 -1 -1 -1 -1
9  8  7  6  5  4  3  2  1 -1 -1 -1 -1
10 9  8  7  6  5  4  3  2  1 -1 -1 -1
11 10 9  8  7  6  5  4  3  2  1 -1 -1
