-1  5  5  5  5  5 -1  5  5  5  5  5 -1
-1  5  7  7  7  5 -1  5  7  7  7  5 -1
-1  5  7  9  7  5 -1  5  7  9  7  5 -1
-1  5  7  7  7  5 -1  5  7  7  7  5 -1
-1  5  5  5  5  5 -1  5  5  5  5  5 -1
