-1 -1 -1 -1 -1 -1 12 -1 -1 -1 -1 -1 -1
-1 -1 -1 -1 -1 12  9 12 -1 -1 -1 -1 -1
-1 -1 -1 -1 12  9 11  9 12 -1 -1 -1 -1
-1 -1 -1 12  9 11  4 11  9 12 -1 -1 -1
-1 -1 12  9 11  4  6  4 11  9 12 -1 -1
-1 -1 -1 12  9 11  4 11  9 12 -1 -1 -1
-1 -1 -1 -1 12  9 11  9 12 -1 -1 -1 -1
-1 -1 -1 -1 -1 12  9 12 -1 -1 -1 -1 -1
-1 -1 -1 -1 -1 -1 12 -1 -1 -1 -1 -1 -1
